####################
#                  #
#                  #
#       #          #
#       #          #
#       ####       #
#                  #
#                  #
#                  #
#                  #
#           ###    #
#                  #
#                  #
#                  #
#     #####        #
#     #            #
#     #####        #
#                  #
#                  #
####################