####################
#                  #
# ################ #
# #              # #
# # ##### ###### # #
# # #          # # #
# # # ######## # # #
# # # #      # # # #
# # # # #### # # # #
# # # # #  # # # # #
#   # # ## #   # # #
# # # # ## # # # # #
# # # #    # # # # #
# # # ###### # # # #
# # #        # # # #
# # ########## # # #
# #            # # #
# ####### ###### # #
#                # #
################## #