######################
  #   #    #   #     #
# ### # #### # # # ###
# #      #   #      ##
# # ## # ## ## #### ##
# # #  #     #### #  #
#   #### ### #    ## #
### #    #   ## # ## #
###   #### # #  #    #
#   # # #  # # ## ####
## ##     ##        ##
## ##### ###### ###  #
## #        #   #   ##
#  #### ### # # # # ##
# ###   # ### #   #  #
# #   ###     # # # ##
#   # # ### ###   #  #
### #       #   ### ##
##  # ### ### #      #
#  ## # #   # # # ## #
##      # #   ### #   
######################